xx+--------------+
xx|              |
xx|              |
--+              |
e                |
--+              |
xx|              |
xx|              |
xx+--------------+
