  +--------------+
  |              |
  |              |
--+              |
e                |
--+              |
  |              |
  |              |
  +--------------+
